10011111C1111000000000000C11111
100C1111C0000000001000000001111
1110000000000001111001111100P11
10011111C1111000001000000011111
1C001111C0000000001000000001111
11100000000000000000C11111E0001
1111111111111111111111111111111