111111111111111111
10CEP00PP0E0000001
111111111111111111
